1111111111
1C00100001
10P0101101
10001C1E01
1001111001
1010000001
101C111001
1011100001
10000000C1
1111111111