111111111111111111111111
11111C000000000000C11111
1111C00000000000000C1111
111C0000000000000000C111
11C000000000000000000C11
1C000000000P0000000000C1
100000000000000000000001
10000000CC000CC000000001
1000000C11C0C11C00000001
100000C1111C1111C0000001
10000C11111111111C000001
1000C1111111111111C00001
1000C1111111111111C00001
1000C1111111111111C00001
10000C11111111111C000001
100000C111111111C0000001
1000000C1111111C00000001
10000000C11111C000000001
1C0000000C111C00000000C1
11C0000000C1C00000000C11
111C0000000C00000000C111
1111C00000000000000C1111
11111C00000E000000C11111
111111111111111111111111