111111111111111111111111111111111
1P0010000000000010100000100010101
101010101010101110101110101010101
101000101010100010001000101000001
111011111110111111111110101111111
100010001000000010000000100010001
111010101010101110111110111011101
100000101010100010001000000000001
111111111111101111111111111011111
100000001000000010001000000000001
101110111110101011101010111011101
100010000000101010000010100010001
111111101110111111111110111011111
100010001000000000001000101000001
101010111010101010111011101011101
101000001010101010000000100010001
111111111111101111111111111111101
100010001010101010001000100010001
101011101010101010101011111010101
101010001000000010100000100000101
111011101110111111111110111011101
100010000000100010001000101010001
111010111010111010101011101011101
100000001010000010100000100010001
111111101111111111111110111110111
100000001000000010000000100010001
111011101110111011101010101111101
100010000000100010001010100000001
101111111111101111111110101110111
101010001000100010001000101010001
101011101110111010101011101011101
10000000100000001010000000001EC01
111111111111111111111111111111111