111111111111111111111111111111111
122212222222222212122222122212121
121212121212121112121112121212121
121222121212122212221222121222221
111211111112111111111112121111111
122212221222222212222222122212221
111212121212121112111112111211121
1222221P1212122212221222222222221
111111111111121111111111111211111
122222221222222212221222222222221
121112111112121211121212111211121
122212222222121212222212122212221
111111121112111111111112111211111
122212221222222222221222121222221
121212111212121212111211121211121
121222221212121212222222122212221
111111111111121111111111111111121
122212221212121212221222122212221
121211121212121212121211111212121
121212221222222212122222122222121
111211121112111111111112111211121
122212222222122212221222121212221
111212111212111212121211121211121
122222221212222212122222122212221
111111121111111111111112111112111
122222221222222212222222122212221
111211121112111211121212121111121
122212222222122212221212122222221
121111111111121111111112121112111
121212221222122212221222121212221
121211121112111212121211121211121
122222221222222212122222222212CE1
111111111111111111111111111111111